--##################
..#.......
..#.......
..#.......
..#.......
..#.......
..#.......
..........
#.######..
..........
##########
..#.......
..#.......
..#.......
..#.......
..#.......
..#.......
..........
#.######..
..........