##############
#.#..........#
#.#..........#
#.#..........#
#.#..........#
#............#
#.###........#
#............#
##########...#
#.#..........#
#.#..........#
#............#
#....#.......#
##############