#############################
.............................
b...............2............
....####B.B.####..1..........  ^ = open permanent ! = open and shut permanent * = open when pressed . = open and shut when pressed
.............................
.............................
.....$......&!..##...........
................##...........
.....####.......##...........
.............................
